Original Maze:
. # # # # # # # # # # # # # # # # # # # # # # # # # # # # # # # # # # # # # # # # # # # # # # # # # #
. . . . . . . . . . . . . . . . . . . . # . . . . . # . . . . . . . . . . . . . . . # . . . . . . . #
# # # . # # # . # # # . # # # # # . # # # # # . # . # # # . # . # . # . # . # . # # # # # # # . # . #
# . # . # . . . # . . . . . # . . . . . . . # . # . . . # . # . # . # . # . # . # . # . # . # . # . #
# . # . # # # # # . # . # . # # # . # # # # # . # . # # # # # . # # # # # # # . # . # . # . # # # . #
# . # . # . # . . . # . # . # . # . # . # . . . # . . . # . . . # . . . # . . . . . . . # . . . # . #
# . # . # . # # # # # . # # # . # # # . # # # . # # # # # # # . # . # # # # # . # # # . # . # . # . #
# . . . . . . . # . . . . . . . . . # . # . . . . . # . # . . . . . . . # . # . # . . . . . # . . . #
# # # . # # # # # . # . # # # . # # # . # . # . # # # . # . # . # . # # # . # # # # # . # # # . # # #
# . . . . . # . # . # . # . . . . . # . . . # . # . . . . . # . # . # . . . . . # . . . # . . . . . #
# # # . # # # . # # # . # # # . # # # # # . # # # # # . # . # # # . # # # . # # # # # . # # # . # # #
# . # . # . . . . . . . . . # . . . # . # . . . # . # . # . # . . . . . . . # . # . # . # . . . . . #
# . # # # # # . # . # . # # # . # # # . # . # # # . # # # # # . # . # # # . # . # . # # # . # . # . #
# . . . # . # . # . # . . . # . # . # . . . # . . . . . # . . . # . # . # . . . . . # . . . # . # . #
# . # # # . # # # # # . # # # # # . # . # # # . # . # # # # # # # . # . # # # . # . # # # . # # # # #
# . . . . . . . . . . . . . # . . . . . . . . . # . # . . . # . # . # . . . # . # . . . # . # . # . #
# . # # # . # # # . # . # # # # # . # # # # # . # # # # # . # . # . # . # # # . # # # . # # # . # . #
# . # . . . # . . . # . . . # . # . . . # . . . # . # . . . . . . . . . . . # . . . # . . . # . . . #
# # # . # # # # # . # # # # # . # . # # # # # . # . # . # . # . # # # . # . # # # # # . # # # # # . #
# . # . # . . . . . . . # . . . . . # . # . . . . . . . # . # . . . # . # . . . # . . . . . # . . . #
# . # # # # # . # . # # # . # . # # # . # # # . # . # . # . # # # # # . # . # # # # # . # . # # # . #
# . # . # . # . # . # . . . # . # . # . . . # . # . # . # . . . # . . . # . # . # . # . # . # . # . #
# . # . # . # # # . # # # . # # # . # . # . # . # # # . # . # # # # # # # . # . # . # # # # # . # . #
# . . . . . # . . . # . # . # . . . . . # . # . # . # . # . # . # . # . # . . . # . . . # . . . . . #
# # # . # # # # # . # . # # # # # . # . # # # . # . # # # . # . # . # . # . # # # . # # # # # . # # #
# . # . . . # . . . . . . . # . # . # . . . . . . . . . # . # . . . . . . . # . . . . . # . . . . . #
# . # . # # # # # . # . # . # . # # # . # # # . # . # # # # # # # . # . # # # . # . # . # # # . # . #
# . . . . . # . # . # . # . . . . . . . . . # . # . # . # . # . . . # . # . # . # . # . . . # . # . #
# . # . # . # . # . # # # # # . # # # . # # # # # # # . # . # # # . # # # . # . # . # . # . # . # # #
# . # . # . . . . . . . . . # . # . . . . . # . . . . . . . # . # . . . . . . . # . # . # . . . . . #
# . # # # . # . # . # . # # # # # . # . # . # # # . # . # . # . # . # . # . # # # . # # # . # . # # #
# . . . # . # . # . # . # . # . # . # . # . . . # . # . # . . . . . # . # . # . . . . . # . # . # . #
# # # # # . # # # # # . # . # . # . # # # . # # # # # . # # # . # . # # # . # . # . # . # # # # # . #
# . # . . . # . . . # . # . . . . . # . # . # . # . # . # . # . # . . . # . # . # . # . . . # . # . #
# . # # # . # . # # # . # . # . # . # . # # # . # . # # # . # . # . # . # # # . # # # . # . # . # . #
# . # . . . # . . . # . # . # . # . # . . . # . . . . . . . . . # . # . # . # . . . # . # . . . . . #
# . # # # . # . # # # # # . # # # . # . # # # . # . # # # . # . # # # . # . # # # # # . # # # . # . #
# . . . . . . . . . # . . . . . # . . . . . # . # . # . # . # . # . . . . . . . # . # . # . # . # . #
# # # # # . # # # # # . # . # # # . # . # # # # # # # . # # # # # . # . # . # # # . # # # . # # # . #
# . # . # . # . # . # . # . # . . . # . # . # . # . . . . . # . . . # . # . . . . . . . . . . . # . #
# . # . # . # . # . # # # . # # # . # # # . # . # # # . # # # # # . # # # . # # # . # # # . # . # # #
# . . . . . # . # . # . # . # . # . # . . . . . . . # . . . # . # . # . . . . . # . # . # . # . . . #
# . # . # # # . # . # . # # # . # # # # # # # . # # # . # # # . # . # # # . # . # # # . # # # # # . #
# . # . # . . . . . . . . . . . . . # . . . . . . . . . . . # . . . . . # . # . # . # . . . # . # . #
# . # # # . # . # . # . # . # . # # # # # . # . # . # . # . # . # . # . # # # . # . # . # # # . # # #
# . . . . . # . # . # . # . # . # . # . . . # . # . # . # . # . # . # . . . # . . . . . # . # . . . #
# . # # # . # # # . # # # . # # # . # # # . # # # # # # # . # . # # # . # . # # # . # # # . # . # # #
# . # . . . . . # . . . # . # . . . . . # . # . # . # . # . . . . . # . # . # . . . # . # . . . . . #
# . # . # . # # # . # . # . # . # . # . # # # . # . # . # . # . # # # # # . # # # . # . # . # . # # #
# . # . # . . . # . # . # . . . # . # . . . # . . . . . . . # . . . # . . . # . . . . . . . # . . . .
# # # # # # # # # # # # # # # # # # # # # # # # # # # # # # # # # # # # # # # # # # # # # # # # # # .

Solution:
o # # # # # # # # # # # # # # # # # # # # # # # # # # # # # # # # # # # # # # # # # # # # # # # # # #
o o o o o o o o o o o o * * * * * * * * # . . . . . # . . . . . . . . . . . . . . . # . . . . . . . #
# # # * # # # . # # # o # # # # # * # # # # # . # . # # # . # . # . # . # . # . # # # # # # # . # . #
# * # * # . . . # * * o * * # * * * * * * * # . # . . . # . # . # . # . # . # . # . # . # . # . # . #
# * # * # # # # # * # o # * # # # * # # # # # . # . # # # # # . # # # # # # # . # . # . # . # # # . #
# * # * # * # * * * # o # * # . # * # . # . . . # . . . # . . . # . . . # . . . . . . . # . . . # . #
# * # * # * # # # # # o # # # . # # # . # # # . # # # # # # # . # . # # # # # . # # # . # . # . # . #
# * * * * * * * # . . o . . . . . . # . # . . . . . # . # . . . . . . . # . # . # . . . . . # . . . #
# # # * # # # # # . # o # # # . # # # . # . # . # # # . # . # . # . # # # . # # # # # . # # # . # # #
# * * * * * # . # . # o # . . . . . # . . . # . # . . . . . # . # . # . . . . . # . . . # . . . . . #
# # # * # # # . # # # o # # # . # # # # # . # # # # # . # . # # # . # # # . # # # # # . # # # . # # #
# . # * # . . . . . . o . . # . . . # . # . . . # . # . # . # . . . . . . . # . # . # . # . . . . . #
# . # # # # # . # . # o # # # . # # # . # . # # # . # # # # # . # . # # # . # . # . # # # . # . # . #
# . . . # . # . # . # o . . # . # . # . . . # . . . . . # . . . # . # . # . . . . . # . . . # . # . #
# . # # # . # # # # # o # # # # # . # . # # # . # . # # # # # # # . # . # # # . # . # # # . # # # # #
# . . . . . . . . o o o . . # . . . . . . . . . # . # * * * # . # . # . . . # . # . . . # . # . # . #
# . # # # . # # # o # * # # # # # . # # # # # . # # # # # * # . # . # . # # # . # # # . # # # . # . #
# . # . . . # * * o # * * * # . # . . . # . . . # * # o o o o o o o o o o o # . . . # . . . # . . . #
# # # . # # # # # o # # # # # . # . # # # # # . # * # o # * # . # # # * # o # # # # # . # # # # # . #
# . # . # * * * * o * * # . . . . . # * # . . o o o o o # * # . . . # * # o * * # . . . . . # . . . #
# . # # # # # * # o # # # . # . # # # * # # # o # . # . # * # # # # # * # o # # # # # . # . # # # . #
# . # . # . # * # o # . . . # . # * # * * * # o # . # . # * * * # * * * # o # . # . # . # . # . # . #
# . # . # . # # # o # # # . # # # * # * # * # o # # # . # * # # # # # # # o # . # . # # # # # . # . #
# . . . . . # * * o # * # . # * * * * * # * # o # . # . # * # * # * # . # o . . # . . . # . . . . . #
# # # . # # # # # o # * # # # # # * # * # # # o # . # # # * # * # * # . # o # # # . # # # # # . # # #
# . # . . . # . . o o o o o # * # * # o o o o o . . . . # * # * * o o o o o # . . . . . # . . . . . #
# . # . # # # # # . # . # o # * # # # o # # # . # . # # # # # # # o # * # # # . # . # . # # # . # . #
# . . . . . # . # . # . # o o o o o o o * * # . # . # * # * # . . o # * # . # . # . # . . . # . # . #
# . # . # . # . # . # # # # # * # # # * # # # # # # # * # * # # # o # # # . # . # . # . # . # . # # #
# . # . # . . . . . . . . . # * # * * * * * # * * * * * * * # * # o . . . . . . # . # . # . . . . . #
# . # # # . # . # . # . # # # # # * # * # * # # # * # * # * # * # o # . # . # # # . # # # . # . # # #
# . . . # . # . # . # . # * # * # * # * # * * * # * # * # * * * * o # . # . # . . . . . # . # . # . #
# # # # # . # # # # # . # * # * # * # # # * # # # # # * # # # * # o # # # . # . # . # . # # # # # . #
# . # . . . # . . . # . # * * * * * # * # * # * # * # * # * # * # o o o # . # . # . # . . . # . # . #
# . # # # . # . # # # . # * # * # * # * # # # * # * # # # * # * # . # o # # # . # # # . # . # . # . #
# . # . . . # . . . # . # * # * # * # * * * # * * * * * * * * * # . # o # . # . . . # . # . . . . . #
# . # # # . # . # # # # # * # # # * # * # # # * # * # # # * # * # # # o # . # # # # # . # # # . # . #
# . . . . . . . . . # * * * * * # * * * * * # * # * # * # * # * # * * o o o . . # * # . # * # . # . #
# # # # # . # # # # # * # * # # # * # * # # # # # # # * # # # # # * # . # o # # # * # # # * # # # . #
# . # . # . # . # . # * # * # * * * # * # * # * # * * * * * # * * * # . # o * * * * * * * * * * # . #
# . # . # . # . # . # # # * # # # * # # # * # * # # # * # # # # # * # # # o # # # * # # # * # * # # #
# . . . . . # . # . # . # * # . # * # * * * * * * * # * * * # * # * # . . o o o # * # * # * # * * * #
# . # . # # # . # . # . # # # . # # # # # # # * # # # * # # # * # * # # # . # o # # # * # # # # # * #
# . # . # . . . . . . . . . . . . . # * * * * * * * * * * * # * * * * * # . # o # * # * * * # * # * #
# . # # # . # . # . # . # . # . # # # # # * # * # * # * # * # * # * # * # # # o # * # * # # # * # # #
# . . . . . # . # . # . # . # . # . # * * * # * # * # * # * # * # * # * * * # o o o * * # * # * * * #
# . # # # . # # # . # # # . # # # . # # # * # # # # # # # * # * # # # * # * # # # o # # # * # * # # #
# . # . . . . . # . . . # . # . . . . . # * # * # * # * # * * * * * # * # * # . . o # . # o o o * * #
# . # . # . # # # . # . # . # . # . # . # # # * # * # * # * # * # # # # # * # # # o # . # o # o # # #
# . # . # . . . # . # . # . . . # . # . . . # * * * * * * * # * * * # * * * # * * o o o o o # o o o o
# # # # # # # # # # # # # # # # # # # # # # # # # # # # # # # # # # # # # # # # # # # # # # # # # # o
