.####################################################################################################
..............#.......#.....#.#.......#...#.#.#...#.....#.#.......#.#.#.#...#.#.#...........#.......#
###.#.###.#.#.#.###.#.#.#.###.###.#.#####.#.#.#.###.#.#.#.###.#.###.#.#.#.###.#.###.#.#.###.###.#.###
#.#.#.#...................#.#...#.......#.......#...#.....#.#.....#.#.....#.......#.#...............#
#.#.#.###.###.#.#######.###.#.###.#.#.#####.#.#######.#.###.#.#.#.#.###.#######.###.#.#.###.#.#.#.#.#
#.....#.#.#.....#.#.#.#.#.......#...#.#.#.#.#.#.#.#.#.#.#.....#.#.#.......#.#.#.#.....#.#.......#.#.#
#.#.###.#####.#.#.#.#.#.#.#.#.#####.#.#.#.#.###.#.#.###.#.#.#####.#####.###.#.#.#.#.#.#.#.#.#.###.###
#.#.......#.#.#...............#.#.#...#.#.................#.#.#...#.#.....#...#...............#.....#
#.###.#.###.#.#.#.#.#.###.#.#.#.#.###.#.###.###.#.#.###.#.###.###.#.###.#####.#.#.#.###.#.#.#####.###
#.....#.#.....#...#.#...#.#.#.......#.....#.#...#.....#.#.#.#...#.#...#.#.#.....#...#.#.#.#...#...#.#
#.#.###.###.###.###.#.###.#.###.#.#.#.#.#######.#.#.###.#.#.#.#.#.#.###.#.#.#.#.#.#.#.#.#.#.###.#.#.#
#.#.#.........#.#.....#.........#.#.#.....#.#.#.#...#...#...........#.#.......#.#.#.....#...........#
#.###.#.#.#.#.#####.#.###.#.#.###.#.#.#####.#.#####.#.###.#.#.#.#.#.#.#.#.#.#.#####.#.###.#.###.###.#
#.........#...#.#.......#.#.#.#.....#.#.#.....#.#.#.#.#.....#...#.....#.#.......#.#.........#.......#
#.###.#.#.#.#.#.###.#.###.#######.#.#.#.###.###.#.#######.###.#.###.#.#.#.#.#.###.#.#.###.#####.###.#
#.#...#...........#...#.....#.#.#.#.....#.#...#.#...#.......#.#...#.........#.#.......#.....#.#.#.#.#
#.###.###.#.#.#.#.#.#.###.#.#.#.###.#.###.#.###.#.#####.#.###.#.###.#.#.#.#.#####.#.#.###.###.#.#.#.#
#.#.#.#...#.#.#.....#.......#...#.....#.....#.#.....#...#.#...#.#.......#.#...#.#.#...#.............#
#.#.#######.###.#.###.###.#.#.#.#.#.#.#.#.###.###.#.#.#.#.###.#.###.#.###.#.###.#.#.#.#.#.###.#.#.#.#
#.#.#.#.#.#.#.....#...........#.....#...........#.#.#.#...........#.#.#.....#.......#.....#...#.#...#
#.#.#.#.#.#.#.#.#.###.###.#.#####.#.#.#.#.###.#####.#.#.#.#.#.#.###.#####.#.#.#.#.#.###.###.#.#.###.#
#...#.#.....#.#.....#.........#.#.#.#.....#.#.#.#.#.........#.......#.#.#.......#.#.......#.#.....#.#
#.###.#.#.#.#.#.#.#####.#.#.#.#.#.#.#.#.#.#.#.#.#.#.#.#.#.#####.#.#.#.#.###.#.#.###.#.#.#.#.#.#.###.#
#.......#.........#.#.#.#.#.#.......#.#...............#.#.#.#...#.#.......#.#.....#.............#.#.#
#.#.#.#.#.#.###.#.#.#.#####.#.#.###.###.#.#.#.#.#.#.#####.#.#.#.#.#.#.#.###.###.#.#####.#.#.#.###.###
#.....#.#.#.#.#.#.......#.......#.#.#.#...#...#...#.#.#...#.....#.#.#...#.......#.#.#.#.......#.....#
###.#####.#.#.#.#.#.#.#.###.#.###.###.#.#.###.###.###.#.#.###.#.#.#.###.###.###.###.#.#.###.#####.###
#.#...#.#.......#.#.#.#.#.#.#.#.........#.#.....#.#...#.#.#.......#.#.........#.......#...#.#.#.....#
#.#.###.#.#.###.#####.###.#.#.###.###.###.#.#.#.#####.#.#.###.#.#.#.#.#.#.#.###.#####.#.#.#.#.###.#.#
#...#.....#.#.....#...........#.#.....#.#.........#.......#.............#.#.#.....#.............#.#.#
#.###.#.#######.#.###.###.#.###.#.#####.###.###.###.#.#.#.#.#.#.#.#.#.#####.###.###.###.###.#.#.#.#.#
#.........#.#.......................#.#.......#.#...#...#...#.#.#.......#...#.#.#.#.#.....#.#.#.....#
#.#.#.#.###.###.#.#.#.#.#.#.###.#.###.#.###.###.###.#.#.###.#.###.###.#####.#.#.#.#####.#####.#.#.#.#
#.#...........#.#.......#...#.............#.#.....#.#...#.#.....#.#.#...#.#.....#.#.........#.....#.#
###.#.#####.#######.#.#.#.#.###.#.###.#.#####.#.###.#####.###.#.###.#.###.#.#.#.#.###.#.#####.#.#.#.#
#.#.....#.....#.#.#.#.#.#.....#.#...#.....#.#...#.#.#.#.........#.................#.#.#.#.#.#.#.#.#.#
#.#.#.#.###.###.#.###.#.###.#.###.#.#.#.###.#.#.#.#.#.###.###.#.###.#.###.#.#.#.###.#.#.#.#.#######.#
#...#.#.......#...........#.#.#.#.....#.........#.#.....#.#.....#.#...#.#.....#...........#.#.#.#.#.#
#.#.###.###.#.#.#.#.#.#.#######.###.#.#.###.#.#.#.#.#.###.###.#.#.#.#.#.#.#.#.#.###.#.#.#.#.#.#.#.###
#.....#.#...#.#.#.#.#.#.#.#.#.....#.#...................#.#...#.....#.#...#.#.#.#.#.#.#.#...........#
#.#.#.#######.#.#.#.#.#.#.#.#.#.###.###.###.#.###.#.#.###.#.###.#.#.#.#.#.###.###.###.#.#.#.#.#.#.#.#
#.#.#...#...#.....#.#.#.........#.........#.#...#.....#.#.#.....#.#.......#.....#...........#...#...#
#####.#.###.###.#.#.#.#.#.#.#.#.#.#.#.#.#####.###.#####.#.#.###.#.###.#.#.###.#.###.#.###.#.#.#.###.#
#.#...#.#.......#...#.....#.#.....#...#.#.#.#.#.....#.........#.#.......#.#.....#.......#.#.#.#.#...#
#.#.###.###.###.#.#.###.#####.#.#.#.###.#.#.#####.#.#.#.#.#.#.#.#.#.#.###.###.#.###.#.#######.#.#.###
#.....#.....#.#.#.........#...#.#.....#.....#.#.#.......#.#.#.......#...#.#.#.#...#.#...#.#.........#
#.#.#.#.#.###.#.#.#.###.###.#####.#.#.#.#.#.#.#.#.#.#.###.#.#.#.#.#.#.###.#.#.###.#.#####.###.#.#.#.#
#.#.#...#.#...........#.#.....#...#.#.#.#.#.........#.#.......#.#...#.#...#...........#.........#.#.#
#.#.#######.###.#.#.#.#.#.#.#.#.#.#.#.#.#.#.#.#.#.#.#.#.#.#.###.#.#.#.###.#.#.#.#.#.#.###.#.#.#####.#
#.....#.#.........#.#.......#...#.#.#...................#.#.#.....#.........#.#.#.#.....#...#...#...#
#.#.#.#.#####.#.###.#.#.#.###.#.#####.#.#.#.#.#.#.#.#.#.###.###.#.#.#.###.###.#######.###.#.#.###.#.#
#.......#.#.#...#.......#.#...#.#.#.#.......#...#.#.#.#.#.........#...#...........#...#.#.#.......#.#
###.#.#.#.#.#.#####.#.#.#.###.###.#.#.#.#.#####.#.#.#.#.###.###.#.#.#.###.###.#.#####.#.#.#.#.###.#.#
#.#.#.........#.....#.#.#...#.#.........#.#.#.........#...#.#...............#.#...#.......#.#.#...#.#
#.#.###.#.#.###.#.###.#.#.#####.#.#.###.#.#.#####.#.#.#.#.#.###.#.#.#.###.#.#.#.#.###.#.#.#.#####.#.#
#.#.#.#.#.#.#.#.............#...#.#.#.....#.#.#.#.......#...#...#.....#.#.....#.#...#...#...#.....#.#
#.#.#.#.#####.#.#.#.#.#.#.#.###.#.###.#.#.#.#.#.#.#.###.#.#####.###.#.#.###.#.#.#.###.###.###.#.###.#
#.......#.#.......#.#.#.......#.#.#.#...#.#.#...#...........#.....#.#.....#.#...#.#.....#.#.....#...#
#.#.#.#.#.#.#.#.#.###.#.#.#.#.#.###.###.#.#.#.#.###.###.#.#.#.#.#.#.#.#.#.#.#.#.#####.###.#.#.#.#.#.#
#.#.#.......#.#.#.#.....#.#.......#.#.........#...#.#...#.......#.......#...#.#...#.........#.#.#.#.#
#.#.#.###.#.#.###.###.#.#.###.#.###.#.#.#.#.#.#.###.#.#.#.#.#.#.###.###.#.#.#.#.#.#.#.#.###.###.#.#.#
#.#...#.....#.#.....#...........#.#...#.........#...#.#.#.#.......#...#.#.#.#...#.....#.#...#.......#
###.###.#.#.#.###.#####.#.###.#.#.#.#.###.#.#.#####.#.#.###.#.#.#.#.###.#.#.#.###.#.#.###.#####.###.#
#.....#.#.#.....#.#.#...#.#...#.......#.#...#.#.#.#.......#...#.#.....#...........#...#.......#.#.#.#
###.###.#.###.#.#.#.###.#.###.#.#.#.#.#.#.###.#.#.###.#.#.###.#####.#.#.#.#.#.#.###.#.#.#.#####.#.###
#.....#.....#.#.#.#.#.#.....#.....#.#.....#.#...#.#...#.#...#.#...#.#...#.#.#.#.#.#.........#.......#
###.#.#.#.###.###.#.#.#.#.#.###.###.#.#.#.#.###.#.###.###.#.#####.#.#.#.#.###.#.#.#####.#.#####.#.#.#
#.#.#.....#.............#.....#.#.#.....#...........#...#.....#.......#.#...........#.#.#...#.#.#.#.#
#.###.#.###.#.###.###.#.###.#.#.#.###.#.###.###.#.#.#.###.#.#.#.#.#.#.#.#.#.#.#.#.###.#.#.#.#.#.#.###
#...#.#.......#.#.#.#.#...#.#.#...............#.#.....#.....#...#.#.#.......#.#.......#.#...........#
#.#####.###.#.#.###.#.#.#.#.#####.###.#.###.###.###.#.###.#.#.#.#.#.#.#.###.###.#.###.#.#####.###.###
#.#.#.#.#.#.#...#.......#.#.#.#.......#...#.#.....#.#.#.#.#...#.#...#...#.....#.#.#.#.#...#.........#
#.#.#.###.###.#.###.#.###.#.#.###.#.#.#.#######.#.#.#.#.###.#.#.#.#.#.#####.###.#.#.#.#.#.###.###.###
#.....#.#.......#.#.#.#.#.#.....#...#.....#.#.#.#.........#.......................................#.#
#.#.#.#.#.###.###.#####.#.#.#.#.#####.#.#.#.#.#.#.#.###.#.#.###.#.###.#.###.###.#.#.#.#.#.#.#.#.###.#
#...........#.......#.......#.#...#.#.#...............#.#...#.#.#.#.#...#.........#.#.#.....#.#...#.#
###.#.#.#.#.#.###.#.###.#.#.#.#.###.#####.#.#.###.#.###.#.#.#.###.#.###.###.###.#.#####.###.#.#.#.#.#
#.#.#...........#.....#.#...#.#.#.......#.#.......#...#...#...........#.#.#.#.....#.#.#.#.....#.#.#.#
#.###.#.###.#.###.#.###.#.###.#.#.#.#.#####.#.#.###.###.#.#.#.###.#.#.#.#.#.#.#.#.#.#.#.###.#.#.###.#
#.....#.#.#...#.#.........#.#.....#.#.#.#.....#.#.....#.#.#.#...#...............#.....#...........#.#
###.###.#.#.#.#.###.###.#.#.###.#.#.#.#.#.#.#.#.#.#.#.#.#.#.#.###.#.#.###.#.#.###.#.#.#.###.###.#.#.#
#...............#.#.#.......................#.....#.#...........#.#.#...#...#...#.#.....#...#.#.#.#.#
###.#.#.#.#.#.#.#.#####.###.#.#.#.#.###.#.###.#.###.#.#.#.#.#.###.###.#.###.#.###.#.#.#####.#.#.#.#.#
#.....#...#.#.......#.....#.....#...#.#.................#.#.......#...#...#.#...#.......#.#...#.....#
#.#.###.#.###.#.#.#####.#.#.#.#.#.#.#.#.#.#.#.#.###.#.#.#.#.#.#.#####.#.#.#.#.#.#.#.#.###.#.#.#.#.###
#.#.#.#.#.#.#.#.......#.........#.#.......#.......#.#...#.....#.#.#.....#.............#...#.........#
#.###.#.###.###.#.#.#.#.#.#.###.#.###.#.#.#.#.#.###.#.#.###.#.#.#.###.#.#.#.###.#.#.#.###.###.#.#.#.#
#.#.....#.....#...#...#...#.#.#.......#.....#.......................#.......#.#.#.....#.....#.#...#.#
#.###.#.#.#.#.#####.###.#.###.#.#.#.#.#.#.#####.###.#.#.###.###.#.#####.#.###.###.#.#####.#.#.#.#.#.#
#.#...#...#.#...#.#.#.#.........#.#.........#.#.#...#...#.#.#.#.......#.........#.......#...........#
#########.#.#.#.#.#.#.#.#.###.###.#.#.#.#.#.#.###.#.#.###.#.#.###.#.#####.###.###.#.#.###.#.#.#.#.#.#
#.#.#...#...#.#.#.....#...#.#...#.#...#.#.#.....#.#...#.#.......#.#.#.#...#.....#.#.#.......#.#.....#
#.#.###.###.#.#.#.#.#.#.###.#.###.###.#.#.###.###.#.#.#.#.#.#.#.#.###.###.###.#####.#.#.#.#.#.#.#.#.#
#.....#...#.#.....#.#...#.......#.#.#.....#.........#.....#.#.#.#.#.....#...#.....#.....#...........#
#.#.#.#.#####.#.#.#.#.#.#.#.#.#####.###.#.###.#.#.###.#.#.#####.#.###.#.#.###.#.###.###.###.###.###.#
#.#.#.#.#.......#...#.......#.#.#.#.......#.#...#...#.#.#.#.#.#.....#.#.................#.#.#...#.#.#
#.#.#.#.#.#.#.#.###.#.#.#.#.#.#.#.#####.###.###.#.#.###.#.#.#.#.#.#.###.#.#.#.#.###.#####.#.###.#.#.#
#...........#...#.#.................................#.#.......#.....#.#.#.#.#.#.....#.#.#.#.#.......#
#.#.#.#.#.#.#.#.#.#.#.#.#.#.#.#.#.#.#.#.#.#.#.#.###.#.#.#.#.#.#.#.#.#.#.#.#.#.#.#.###.#.#.#.#.#.#.#.#
#...#.#...............#.#...#...................#.......#.#.#.................#...............#......
####################################################################################################.
