.##########
......#...#
#####.###.#
#...#...#.#
#.#.###.#.#
#.#.#.#.#.#
#.#.#.#.#.#
#.#...#.#.#
#.#####.#.#
#..........
##########.
