.##########################################################################################
........#...#.#.......#.....#...........#.......#.....#...................#.....#.........#
#######.#.#.#.#.###.#.#.###.#.#######.#.###.###.###.#.###.#############.#.#.#.#.#.#######.#
#.....#...#.#.#.#.#.#...#...#.#.....#.#.#...#.#...#.#...#.#.....#...#...#.#.#.#.#.#.....#.#
#.#.#######.#.#.#.#.#########.#.#####.#.#.###.###.#.###.###.###.#.#.#.###.#.#.#.#.#.###.#.#
#.#.......#.#...#.#.....#.....#...#...#...#...#...#.#.......#.....#...#.#.#.#.#...#...#.#.#
#######.###.#.###.#####.#.#######.#.#######.#.#.###.#####.#############.#.###.#######.#.#.#
#.......#...#.....#.....#...#.....#.....#...#.#...#...#...#.....#.......#.#...#.....#.#...#
#.#####.#.#########.#######.###.#######.#.#.#.###.###.#####.###.#######.#.#.#####.#.#.#####
#...#...#.#.......#.#.....#...#.#...#...#.#.#...#.#...#.....#...#.......#...#.....#.#.....#
#.#.#.###.#.#####.#.#.###.###.#.#.#.#.###.#.###.#.#.###.#####.###.#####.#####.#.###.#####.#
#.#.#...#...#...#.#.....#.#...#.#.#.#...#.#...#.#.#.....#...#...#.....#...#...#...#.#...#.#
###.#.#######.###.#####.#.#.###.#.#.###.#.###.###.#.#####.#.###.#####.#####.#####.#.#.###.#
#...#.#.....#...#.....#.#.....#.#.#.....#.#.#.....#.#.....#.#...#...#.#.....#...#.#...#...#
#.#####.###.#.#.#####.#######.#.#.#######.#.#######.#.#####.#.###.#.#.#.#######.#.#.###.###
#.#...#.#...#.#.#...#.....#...#.#.....#.........#...#.#...#...#...#...#.........#.#.#...#.#
#.#.#.#.#.#.#.#.#.#.#####.#.###.#####.#########.#####.#.#######.#.#####.#######.#.#.#.###.#
#.#.#...#.#.#.#...#.......#.#.......#...#...#.#.......#.....#...#.....#.#...#...#.#.#.#...#
#.#.#####.#.#.#############.#.###.#####.#.#.#.###########.###.#######.#.#.#.###.#.###.#.#.#
#...#...#.#.#.#.#...........#.#...#...#...#.#...#.......#.....#.#.....#.#.#...#.#...#.#.#.#
#.###.#.#.###.#.#.###########.#####.#.#####.#.###.###.#.###.###.#.#####.#.###.#.###.#.###.#
#.....#.#.#...#...............#.....#.......#.#...#...#...#.....#.#.....#.#.#.#.#...#...#.#
#.#######.#.#################.#.#####.#######.#.###.#####.#######.#.#####.#.#.###.#.###.#.#
#.#...#...#.......#.#.........#.#.....#.....#...#...#...........#.......#.#.#.#...#...#.#.#
#.#.#.#.#.#######.#.#.#########.#.#####.###.###.#.###.#########.#######.#.#.#.#.#####.#.#.#
#.#.#.#.#.....#.#.#...#.....#...#.#.......#...#.#.#...#.......#.......#.#.#...#...#...#.#.#
###.#.#.#####.#.#.#.###.###.#.#####.#########.###.#####.#####.#######.###.#.#####.#.###.#.#
#...#.#.#.....#.#.#.....#...#.......#.....#...#...#.....#...#...#...#.....#.#.....#...#.#.#
#.###.#.#####.#.#.#########.#########.###.#.###.###.#####.#.###.#.#.#.#####.#.#######.#.#.#
#.#.....#...#...#.........#.......#...#.....#.......#.....#.#...#.#.#.#...#...#...#...#...#
#.#####.#.#.###.#########.#####.###.#.#####.#######.#.#######.###.#.###.#.#####.#.###.###.#
#.#...#.#.#...#...#.....#...#...#...#.#...#.#.....#...#.....#.#...#.....#.#...#.#...#...#.#
#.#.#.###.###.###.#.#######.#.###.###.#.#.###.###.###.#.###.#.#.#########.#.#.#.###.###.#.#
#.#.#.....#...#...#.#.......#...#...#.#.#.#.....#...#.#.#.....#.#.......#...#...#.#.#...#.#
#.#.#######.###.###.#.#########.###.###.#.#.#######.#.#.#######.#.#####.#########.#.#####.#
#...#...#...#.#...#.#.#.......#...#.....#.....#.....#.#.........#...#...#.........#.#.....#
#####.#.#.###.###.#.#.#####.#.###############.#.#####.#############.#.###.#######.#.#.#####
#.....#...#.....#.#.#.......#.......#.......#.#.#...#.....#.....#...#.#.#.....#...#.#.#...#
#.###########.#.#.#.###############.#.#####.###.#.#.#####.#.###.#.###.#.#####.#.###.#.#.#.#
#.#...........#.#.#.........#.......#.#.......#.#.#.....#...#.#...#.#.#.......#...#...#.#.#
#.#.#######.###.#.#####.#####.#######.#######.#.#####.#.#####.#####.#.#.#####.###.#######.#
#.#...#...#...#.#.#...#.....#...#.........#.#.#.....#.#...........#...#.#...#.#...#...#...#
#.###.#.#.###.###.#.#.#####.###.#.#######.#.#.#.###.#.#######.#####.###.#.#.###.#.#.#.#.#.#
#.#...#.#...#...#...#.......#.#.#.#.....#.#...#.#...#.#.....#.#.....#...#.#.....#...#.#.#.#
#.#####.###.#.#.###########.#.#.###.###.#.#.#####.###.#.###.#.#.#######.#.###########.#.###
#.......#.#.#.#...........#.#.#...#...#...#.......#...#.#...#.#.#.....#.#.#.........#.#...#
#.#######.#.###.###.#####.#.#.###.#.#.#############.###.#.###.#.###.#.###.#.#.#####.#.###.#
#.#.......#...#...#...#...#.....#.#.#.......#.....#.#...#...#...#...#...#.#.#...#.#.#...#.#
#.###.###.###.###.###.#########.#.#####.###.#####.#.#######.#####.#####.#.#.###.#.#.###.#.#
#.#...#.....#.#.#...#.........#.#.....#...#.....#.#.#...........#...#.....#.#...#...#.#...#
#.#.#######.#.#.###.#####.#####.#####.#########.#.#.#.#########.#.#.#########.###.###.###.#
#.#.......#.#.#.#...#...#.....#.#...#.....#...#.#...#.#.#.....#.#.#...#.......#.....#...#.#
#.#.#####.#.#.#.#.###.#.#####.#.#.#.#####.#.#.#.#.###.#.#.###.#.#####.#.###.#######.#.###.#
#.#.#.....#.#.#...#...#.....#.#.#.#.#...#...#...#.#...#.#...#...#.....#.#.#.......#...#...#
#.###.#####.#.###.#.#######.#.#.#.#.###.#########.#.###.###.#####.#####.#.#######.#####.###
#.#...#...#.#...#.#...#.......#.#.#.............#...#.....#...#.....#...#.......#.......#.#
#.#.#####.#.###.#.###.#########.#.#######.#####.#####.#.#####.#.###.#.#####.###.#########.#
#.#.....#.#.#...#...#.#.........#...#...#.#...#.....#.#.......#.#.#.#.#...#.#.#.#...#.....#
#.#####.#.#.#.#######.#.#########.#.#.#.###.#.#####.#.#########.#.#.#.#.#.#.#.#.#.#.#.###.#
#.#...#.#...#.#.......#.....#.....#...#.#...#.....#.#.#.#.....#...#.#...#...#.#...#...#...#
#.#.#.#.#####.#.#####.#####.#.#########.#.#######.###.#.#.#.#.#####.#########.#########.###
#...#.#.#.....#...#...#...#.#.....#...#.#...#.#...#...#...#.#.......#...#.......#.....#.#.#
#####.#.#.#####.#.#####.#.#.#######.#.#.###.#.#.###.###.###.###########.#.###.###.#.#.#.#.#
#.......#.....#.#.......#.#...#.....#.#.#...#.#.#...#...#...#...........#.#.#.#...#.#.#.#.#
#############.#.#########.###.#.#####.#.#.###.#.#.###.###.###.#######.###.#.#.#.###.###.#.#
#...........#.#.........#...#...#.......#.#...#.#.#.#.#.#.#.#.#...#.#...#.#.#...#.#...#...#
#.#########.#.###########.#.#.###########.#.#.#.#.#.#.#.#.#.#.#.#.#.###.#.#.#####.###.###.#
#.#...........#.........#.#...#.........#.#.#.#...#...#.#.#.#...#.....#.#.#.........#...#.#
#.#############.#######.#.#####.#######.#.#.#######.###.#.#.#######.###.#.#.#######.#.###.#
#.......#.......#...#...#.#...#.......#...#.#.....#.#...#.#.......#.#...#.#.......#.#.....#
#.#####.#.#####.#.###.###.#.#.#######.#####.#.#.###.#.#.#.#######.#.#.###.#####.###.#######
#...#...#.#...#...#...#...#.#...#...#.....#.#.#...#...#.#.#.......#.#...#.....#.#.........#
###.#.###.#.#.###.#.###.###.###.#.#.#####.#.#.###.#####.#.#.#####.#.###.#####.#.#.#########
#...#.#...#.#...#.#.#...#...#...#.#.#.....#.....#.....#.#.#.#.....#.#.#.....#.#.#.........#
#####.#.###.###.###.###.###.#.#.#.#.#.#####.#######.###.#.#.#######.#.###.###.#.#########.#
#.....#.#.#...#...#...#...#.#.#.#.#...#...#.#.....#.#...#.#.......#.....#...#.#.#...#.....#
#.###.#.#.###.###.#.#.###.###.###.#####.#.###.###.#.#.###.###.###.###.#####.#.###.#.#.###.#
#.#...#.#.#...#...#.#.#.....#.#...#.....#...#...#.#.....#...#...#.#...#...#.#.....#.#...#.#
#.#####.#.#.###.#####.#####.#.#.###.#######.###.#.#######.#.#####.#.###.#.#.#######.###.#.#
#.#...#...#...#.......#...#...#.#...#.....#.....#.#.....#.#...#...#.#.#.#.#.......#...#.#.#
#.#.#.###.###.#########.#.#####.###.#.###########.#.###.#####.#.###.#.#.#.#.#########.#.#.#
#...#...#.#.#...#.......#.......#...#.#.......#...#.#.....#...#.#...#.#.#...#.......#.#.#.#
#.#####.#.#.###.#.###############.###.#.###.###.###.#####.#.###.#.###.#.###.#.#####.#.#.###
#.#...#.#...#.#...#...#.....#...#.#.....#...#...#.....#.#...#...#.#...#.#...#.#...#...#...#
###.#.#.###.#.#####.#.###.#.#.#.#.#.#####.#.#.#######.#.#######.#.###.#.#.###.#.#.#######.#
#...#.#...#...#...#.#.....#...#...#.#.....#.#.........#.........#.....#.#...#...#.#.......#
#.###.###.###.#.#.#.###############.#.#################.#######.#####.#.#########.###.###.#
#.#.........#...#...#.........#.....#...#.........#.....#...#.....#...#.#.......#.....#.#.#
#.###################.###.#####.#######.#.#####.###.###.#.#.#######.###.#.#.###########.#.#
#.......................#.............#.......#.......#...#...........#...#................
##########################################################################################.