.##################################################
....................#.....#...............#.......#
###.###.###.#####.#####.#.###.#.#.#.#.#.#######.#.#
#.#.#...#.....#.......#.#...#.#.#.#.#.#.#.#.#.#.#.#
#.#.#####.#.#.###.#####.#.#####.#######.#.#.#.###.#
#.#.#.#...#.#.#.#.#.#...#...#...#...#.......#...#.#
#.#.#.#####.###.###.###.#######.#.#####.###.#.#.#.#
#.......#.........#.#.....#.#.......#.#.#.....#...#
###.#####.#.###.###.#.#.###.#.#.#.###.#####.###.###
#.....#.#.#.#.....#...#.#.....#.#.#.....#...#.....#
###.###.###.###.#####.#####.#.###.###.#####.###.###
#.#.#.........#...#.#...#.#.#.#.......#.#.#.#.....#
#.#####.#.#.###.###.#.###.#####.#.###.#.#.###.#.#.#
#...#.#.#.#...#.#.#...#.....#...#.#.#.....#...#.#.#
#.###.#####.#####.#.###.#.#######.#.###.#.###.#####
#.............#.........#.#...#.#.#...#.#...#.#.#.#
#.###.###.#.#####.#####.#####.#.#.#.###.###.###.#.#
#.#...#...#...#.#...#...#.#...........#...#...#...#
###.#####.#####.#.#####.#.#.#.#.###.#.#####.#####.#
#.#.#.......#.....#.#.......#.#...#.#...#.....#...#
#.#####.#.###.#.###.###.#.#.#.#####.#.#####.#.###.#
#.#.#.#.#.#...#.#.#...#.#.#.#...#...#.#.#.#.#.#.#.#
#.#.#.###.###.###.#.#.#.###.#.#######.#.#.#####.#.#
#.....#...#.#.#.....#.#.#.#.#.#.#.#.#...#...#.....#
###.#####.#.#####.#.###.#.###.#.#.#.#.###.#####.###
#.#...#.......#.#.#.........#.#.......#.....#.....#
#.#.#####.#.#.#.###.###.#.#######.#.###.#.#.###.#.#
#.....#.#.#.#.........#.#.#.#.#...#.#.#.#.#...#.#.#
#.#.#.#.#.#####.###.#######.#.###.###.#.#.#.#.#.###
#.#.#.........#.#.....#.......#.#.......#.#.#.....#
#.###.#.#.#.#####.#.#.###.#.#.#.#.#.#.###.###.#.###
#...#.#.#.#.#.#.#.#.#...#.#.#.....#.#.#.....#.#.#.#
#####.#####.#.#.#.###.#####.###.#.###.#.#.#.#####.#
#.#...#...#.#.....#.#.#.#.#.#.#.#...#.#.#.#...#.#.#
#.###.#.###.#.#.#.#.###.#.###.#.#.#.###.###.#.#.#.#
#.#...#...#.#.#.#.#...#.........#.#.#.#...#.#.....#
#.###.#.#####.###.#.###.#.###.#.###.#.#####.###.#.#
#.........#.....#.....#.#.#.#.#.#.......#.#.#.#.#.#
#####.#####.#.###.#.#######.#####.#.#.###.###.###.#
#.#.#.#.#.#.#.#...#.#.#.#.....#...#.#...........#.#
#.#.#.#.#.###.###.###.#.###.#####.###.###.###.#.###
#.....#.#.#.#.#.#.#.......#...#.#.#.....#.#.#.#...#
#.#.###.#.#.###.#######.###.###.#.###.#.###.#####.#
#.#.#.............#...........#.....#.#.#.#...#.#.#
#.###.#.#.#.#.#.#####.#.#.#.#.#.#.#.###.#.#.###.###
#.....#.#.#.#.#.#.#...#.#.#.#.#.#.#...#.....#.#...#
#.###.###.###.###.###.#######.#.###.#.###.###.#.###
#.#.....#...#.#.....#.#.#.#.#.....#.#.#...#.#.....#
#.#.#.###.#.#.#.#.#.###.#.#.#.#.#####.###.#.#.#.###
#.#.#...#.#.#...#.#...#.......#...#...#.......#....
##################################################.